Date,Transaction ID,Description,Amount,Category,Account Type,Balance,Reference Number
2024-01-15,TXN001234,STARBUCKS COFFEE #1234,-45.67,Food & Drink,Checking,2954.33,REF789123
2024-01-14,TXN001235,AMAZON.COM PURCHASE,-123.45,Shopping,Checking,3000.00,REF789124
2024-01-13,TXN001236,SALARY DEPOSIT - ACME CORP,2500.00,Income,Checking,3123.45,REF789125
2024-01-12,TXN001237,GROCERY STORE PURCHASE,-89.99,Food & Groceries,Checking,623.45,REF789126
2024-01-11,TXN001238,GAS STATION FUEL,-45.00,Transportation,Checking,713.44,REF789127
2024-01-10,TXN001239,ATM WITHDRAWAL,-100.00,Cash,Checking,758.44,REF789128
2024-01-09,TXN001240,NETFLIX SUBSCRIPTION,-15.99,Entertainment,Checking,858.44,REF789129
2024-01-08,TXN001241,ELECTRIC COMPANY PAYMENT,-125.50,Utilities,Checking,874.43,REF789130